NO ./main_menu/pa.xpm

SO ./main_menu/pa.xpm

WE ./main_menu/pa.xpm

EA ./main_menu/pa.xpm

F 144,144,144

C 0,255,0

    1111111111111111111111
    1000000010000000000001
    1000000010000000000001
111110000000000000000000011111111111111111111111111111111111
100000000000S00000000110000000000000000000000000000000000001
100000000000010000000000000000000000000000000000000000000001
110010011110001000000011111111111111111111111111111111111111
10000001  1000000000001
1000000111111000000001
111111111    111111111
