NO ./main_menu/pa.xpm

SO ./main_menu/pa.xpm

WE ./main_menu/pa.xpm

EA ./main_menu/pa.xpm

F 144,144,144

C 0,255,0


11111111111111111111
10000010000000100011
10000010010000110111
10000100000000100001
11000010000001000111
10010000000010000001
10000000001000000001
10N00000110000000101
10000000000000000001
11111111111111111111